F F F F F F F F F F F F F F F F
F F W W W W W W W W F F F F F F
F F W F F B F F F W F F F F F F
F F W F F W P P F W F F F F F F
F F W W F P F F W W F F F F F F
F F F W F F P S W F F F F F F F
F F F W W F S W W F F F F F F F
F F F F W S S W F F F F F F F F
F F F F W W W W F F F F F F F F