F F F F F F F F F F F F F F F F
F W W W W W W W W W F F F F F F
F W S S S S S F F W F F F F F F
F W W W F P F W F W W F F F F F
F F F W F P W W F F W F F F F F
F F F W P F P F P F W F F F F F
F F F W F F F W F F W F F F F F
F F F W W F F W F B W F F F F F
F F F F W W W W W W W F F F F F