F F F F F F F F F F F F F F F F
F F F F F F F F F F F F F F F F
F F F W W W W W W W W F F F F F
F F F W F F B F F F W F F F F F
F F W W P F P F P F W F F F F F
F F W F P F W F P F W F F F F F
F F W F F P F W F W W F F F F F
F F W S S S S S S W F F F F F F
F F W W W W W W W W F F F F F F