F F F F W W W W W W W F F F F F
F F F F W F F F F F W F F F F F
F F F F W F P F B F W F F F F F
F F W W W W W F W F W F F F F F
F F W F P F F F F F W F F F F F
F F W F F W P W W F W W F F F F
F F W S S P F F W F F W F F F F
F F W S S F F F F F F W F F F F
F F W W W W W W W W W W F F F F