F F F F F F F F F F F F F F F F
F F F F F F F F F F F F F F F F
F F F F F W W W W W F F F F F F
F F F F F W F F F W W F F F F F
F F F W W W F p P F W F F F F F
F F F W F F S P S F W F F F F F
F F F W F F P S F W W F F F F F
F F F W W W F F B W F F F F F F
F F F F F W W W W W F F F F F F