F F F F F F F F F F F F F F F F
F F F F F F F F F F F F F F F F
F F F F F F F F F F F F F F F F
F F W W W W W W W W W W F F F F
F F W F B W W W S S S W F F F F
F F W F P P F F S P S W F F F F
F F W F F F W P W P F W F F F F
F F W W F F F F F F F W F F F F
F F W W W W W W W W W W F F F F