F F F F F F F F F F F F F F F F
F F F F W W W W W W W W F F F F
F F F F W S F F F P F W F F F F
F F F F W S P F F W F W F F F F
F F F F W S W F W F F W F F F F
F F F F W W W F W F W W F F F F
F F F F F W F P F F W F F F F F
F F F F F W B F W W W F F F F F
F F F F F W W W W W F F F F F F