W W W W W W W W W W W F F F F F
W F F F F F W F B F W F F F F F
W F P F F P F F P F W F F F F F
W W F W S S S W F W W F F F F F
F W F W S S S W F W F F F F F F
F W P F W W W F P W F F F F F F
F W F F F P F F F W F F F F F F
F W F F W W F F F W F F F F F F
F W W W W W W W W W F F F F F F