F F F F F F F F F F F F F F F F
F F F F F F F F F F F F F F F F
F F F W W W W W W W W F F F F F
F F F W F B F F F F W F F F F F
F F W W F F S S P F W F F F F F
F F W F F W S S W W W F F F F F
F F W F P P P W W F F F F F F F
F F W F F F F W F F F F F F F F
F F W W W W W W F F F F F F F F