F F F W W W W W W W F F F F F F
F F W W F F p F F W W F F F F F
F F W F S F S B S F W F F F F F
F F W F F F p F P F W F F F F F
F F W p P P p P P p W F F F F F
F F W F P F p F F F W F F F F F
F F W F S F S F S F W F F F F F
F F W W F F p F F W W F F F F F
F F F W W W W W W W F F F F F F