F F F F F F F F F F F F F F F F
F F W W W W W F F F F F F F F F
F F W F F F W W W W W F F F F F
F F W F P F W F F F W F F F F F
F F W F F F W P W F W F F F F F
F F W W W P F F F F W F F F F F
F F F W F F F W W W W F F F F F
F F F W F B S S S W F F F F F F
F F F W W W W W W W F F F F F F