F F F F F F F F F F F F F F F F
F F F F F F F F F F F F F F F F
F F F F F W W W W W F F F F F F
F W W W W W F F F W F F F F F F
F W S S F P F P F W W F F F F F
F W S S P F P F F B W F F F F F
F W W S F P W W F W W F F F F F
F F W W W F F F F W F F F F F F
F F F F W W W W W W F F F F F F