W W W W W W W W W W W W W W W W
W F F F F F F F F F F F F F S W
W F F F F F F F F F F F F S S W
W F F F W W W W W W W W W W W W
W F F F F F F P B P F F F F F W
W F F F F F F F F F F F F F F W
W F F F F F F F F F P F F F F W
W F F F F F F F F F F F F F F W
W W W W W W W W W W W W W W W W
# W = wall, F = free, P = sarcophagus, S = spot, B = bug
# Conditions: nr. of P = nr. of S.
# Note: the bug(B) and sarcophagus(P) are on top of a free(F) ground