F F F F F W W W W F F F F F F F
F F F F F W S F W F W W W F F F
F F F W W W P F W W W S W F F F
F F F W F F S P S F F F W F F F
F F F W F F F W W P P F W F F F
F F F W F P P S W B F F W F F F
F F F W F F P S W W W W W F F F
F F F W W W F F F S W F F F F F
F F F F F W W W W W W F F F F F