F F F F F F F F F F F F F F F F
F W W W W W W W W W F F F F F F
F W F F S W F F F W F F F F F F
F W F F P F P p S W F F F F F F
F W F P W W F W F W F F F F F F
F W F F F W F F F W F F F F F F
F W F p F W F F W W F F F F F F
F W W F F S B W W F F F F F F F
F F W W W W W W F F F F F F F F