F F F F F F F F F F F F F F F F
F F F F F F F F F F F F F F F F
F F F F F F F F F F F F F F F F
F W W W W W W W W W W F F F F F
W W F F F F W F B F W W F F F F
W F F P S S S S F P F W F F F F
W F P F W W W W P F F W F F F F
W W F F W F F W F F F W F F F F
F W W W W F F W W W W W F F F F