F F F F F F F F F F F F F F F F
F F F W W W W W W W W F F F F F
F F F W F F W F F F W F F F F F
F F F W B P S S P F W F F F F F
F F F W F P S p F W W F F F F F
F F F W F P S S P F W F F F F F
F F F W F F W F F F W F F F F F
F F F W W W W W W W W F F F F F
F F F F F F F F F F F F F F F F