F F W W W W W W W W W W F F F F
F W W F F S S S S S F W F F F F
F W F F W S S S S S F W F F F F
F W F P F W W W W F W W F F F F
F W F P F F B F F F W F F F F F
F W W F P F P F P F W F F F F F
F F W F P P P P P F W F F F F F
F F W F F F W F F F W F F F F F
F F W W W W W W W W W F F F F F