F F F W W W W W F F F F F F F F
F F F W F F B W F F F F F F F F
F F F W F P P W F W W W F F F F
F F F W F P F W F W S W F F F F
F F F W W W F W W W S W F F F F
F F F F W W F F F F S W F F F F
F F F F W F F F W F F W F F F F
F F F F W F F F W W W W F F F F
F F F F W W W W W F F F F F F F