F F F F F W W W W F F F F F F F
F F F F W W F F W F F F F F F F
F F F F W F F P W F F F F F F F
F F F F W W B F W W F F F F F F
F F F F W W P P F W F F F F F F
F F F F W S P F F W F F F F F F
F F F F W S S p S W F F F F F F
F F F F W W W W W W F F F F F F
F F F F F F F F F F F F F F F F