F F F F F F F F F F F F F F F F
F F F W W W W W F F F F F F F F
W W W W F B F W W W F F F F F F
W F F F F W F F F W F F F F F F
W F P P F F W P F W F F F F F F
W F F P W P F P F W F F F F F F
W W W S S S P W W W F F F F F F
F W S S S S F W F F F F F F F F
F W W W W W W W F F F F F F F F