F F F F F F F F F F F F F F F F
F F F F F F F F F F F F F F F F
F F F F W W W W W F F F F F F F
F F F W W F F F W W W F F F F F
F F F W F S W F P B W F F F F F
F F F W F F W F W F W F F F F F
F F F W F p F F P S W F F F F F
F F F W F F F F W W W F F F F F
F F F W W W W W W F F F F F F F