F F F F F F W W W W W W W F F F
F F F F F F W F F B F F W F F F
F F F W W W W F W F P F W F F F
F F F W S S S P W P F W W F F F
F F F W S S S F P F F F W F F F
F F F W W W F P F W W F W F F F
F F F F F W F P F F F F W F F F
F F F F F W F F F F W W W F F F
F F F F F W W W W W W F F F F F